############################
#............##............#
#.####.#####.##.#####.####.#
#*#  #.#   #.##.#   #.#  #*#
#.####.#####.##.#####.####.#
#..........................#
#.####.##.########.##.####.#
#.####.##.########.##.####.#
#......##....##....##......#
######.##### ## #####.######
     #.##### ## #####.#'''''
     |.##          ##.|'''''
     #.## ###__### ##.#'''''
######.## #      # ##.######
|.......  #      #  .......|
######.## #      # ##.######
     #.## ######## ##.#'''''
     #.##    P     ##.#'''''
     #.## ######## ##.#'''''
######.## ######## ##.######
#............##............#
#.####.#####.##.#####.####.#
#.####.#####.##.#####.####.#
#*..##.......  .......##..*#
###.##.##.########.##.##.###
###.##.##.########.##.##.###
#......##....##....##......#
#.##########.##.##########.#
#.##########.##.##########.#
#..........................#
############################
