############################
#............##............#
#.####.#####.##.#####.####.#
#*#  #.#   #.##.#   #.#  #*#
#.####.#####.##.#####.####.#
#..........................#
#.####.##.########.##.####.#
#.####.##.########.##.####.#
#......##....##....##......#
######.##### ## #####.######
'''''#.##### ## #####.#'''''
'''''|.##          ##.|'''''
'''''#.## ###  ### ##.#'''''
######.## # +  + # ##.######
|.......  #      #  .......|
######.## # +  + # ##.######
'''''#.## ######## ##.#'''''
'''''#.##    P     ##.#'''''
'''''#.## ######## ##.#'''''
######.## ######## ##.######
#............##............#
#.####.#####.##.#####.####.#
#.####.#####.##.#####.####.#
#*..##.......  .......##..*#
###.##.##.########.##.##.###
###.##.##.########.##.##.###
#......##....##....##......#
#.##########.##.##########.#
#.##########.##.##########.#
#..........................#
############################
