###########################
#                         #
#   ##               ##   #
# ##                   ## #
#                         #
#                         #
#                         #
#                         #
#                         #
#                         #
#                         #
#                         #
#                         #
#           0001          #
#                         #
#                         #
#                         #
#                         #
#                         #
#                         #
#                         #
#                         #
#                         #
#  ##                  ## #
#    ##              ##   #
#                         #
###########################